1 1 1 1 1 1 1 1 1 1 1 1 1 1 1 1 1 1 1 1 1 1 1 1 1 
1 0 0 0 0 0 0 0 0 0 0 0 0 0 0 0 0 0 0 0 0 0 0 0 1 
1 0 0 0 0 0 0 0 0 0 0 0 0 0 0 0 0 0 0 0 0 0 0 0 1 
1 0 0 0 0 0 0 0 0 0 0 0 0 0 0 0 0 0 0 0 0 0 0 1301 1 
1 0 1701 0 0 0 0 0 0 0 0 0 201 201 201 201 201 0 0 201 1 1 1 1 1 
1 201 201 201 201 105 301 0 1402 0 0 0 0 0 0 0 0 0 0 0 0 0 0 0 1 
1 0 0 0 0 0 301 0 105 0 0 201 0 0 0 0 0 0 0 0 0 0 0 0 1 
1 0 0 0 0 0 301 0 0 105 0 0 0 0 0 0 0 0 0 0 0 0 0 0 1 
1 0 0 0 0 0 301 0 0 0 105 0 0 0 0 0 0 0 0 0 1701 0 1403 0 1 
1 0 0 0 0 0 301 0 0 0 0 105 105 105 0 0 105 105 201 201 201 201 201 301 1 
1 0 0 0 0 0 301 0 0 0 0 0 0 0 0 0 0 0 0 0 0 0 0 301 1 
1 0 0 0 0 0 301 0 0 0 0 0 0 0 0 0 0 0 0 0 0 0 0 301 1 
1 0 1701 0 1403 0 301 0 0 0 0 0 0 201 201 201 201 201 0 0 0 0 0 301 1 
1 1 1 1 1 1 1 1 1 1 1 0 0 0 0 0 0 0 0 0 0 0 0 301 1 
1 0 0 0 0 0 0 0 0 0 0 0 0 0 0 0 0 0 0 0 0 1701 0 301 1 
1 0 0 0 0 0 0 0 0 0 0 0 0 0 0 1401 0 0 0 201 106 201 201 101 1 
1 0 0 0 0 0 0 0 0 1401 0 0 0 205 105 105 105 105 0 0 0 0 0 0 1 
1 0 0 0 0 0 0 0 105 105 105 105 0 0 0 0 0 0 0 0 0 0 0 0 1 
1 0 0 105 105 105 0 0 0 0 0 0 0 0 0 0 0 0 0 0 0 0 0 0 1 
1 0 0 0 0 0 0 0 0 0 0 0 0 0 0 0 0 0 0 0 0 0 0 0 1 
1 105 0 0 0 0 0 0 0 0 0 0 0 0 0 0 0 0 0 0 0 0 0 0 1 
1 105 105 105 105 105 105 0 0 105 105 105 104 105 104 105 104 105 105 104 105 105 301 0 1 
1 0 0 0 0 0 0 0 0 0 0 0 0 0 0 0 0 0 0 0 0 0 301 0 1 
1 0 0 0 0 0 0 0 0 0 0 0 0 0 0 0 0 0 0 0 0 0 301 0 1 
1 0 0 0 0 0 0 0 0 0 0 0 0 0 0 0 0 0 0 0 0 0 301 0 1 
1 0 0 0 0 0 0 0 0 0 0 0 0 0 0 0 0 0 0 205 205 205 105 0 1 
1 1201 1202 0 0 0 0 0 0 0 0 0 0 0 0 0 201 1 601 601 601 601 601 601 1 
1 1 1 201 0 0 0 0 0 0 0 0 0 0 201 1 1 1 601 601 601 601 601 601 1 
1 1 1 1 1 1 1 1 1 1 1 1 1 1 1 1 1 1 1 1 1 1 1 1 1 
