3 3 3 3 3 3 3 3 3 3 3 3 3 3 3 3 3 3 3 3 3 3 3 3 3 
3 0 0 0 82 0 0 0 0 0 0 0 0 0 0 0 0 0 0 0 0 0 0 33 3 
3 808 0 0 78 0 0 0 0 0 0 0 0 0 0 0 0 0 0 0 0 0 0 33 3 
3 3 3 0 77 0 3 3 3 3 3 3 3 3 3 3 3 3 3 3 3 3 3 33 3 
3 5 1 24 78 23 1 1 1 1 4 1 30 80 0 0 0 0 29 1 1 1 1 33 3 
3 1 1 1 4 4 4 4 4 1 1 1 33 78 0 0 0 0 0 1 4 5 1 33 3 
3 1 5 1 1 1 1 1 1 1 1 1 33 77 0 0 0 0 0 1 1 1 1 33 3 
3 5 5 1 1 30 0 0 0 0 29 1 33 1 1 1 1 1 1 1 30 80 0 33 3 
3 5 5 1 1 0 0 0 0 0 0 0 33 0 0 0 0 0 0 0 0 78 0 33 3 
3 1 1 1 1 0 707 0 708 0 0 0 33 0 23 5 4 1 1 24 0 77 0 33 3 
3 3 3 3 3 3 3 3 3 3 3 3 3 3 3 0 82 0 0 3 3 3 3 33 3 
3 0 0 0 0 0 0 0 0 0 0 0 0 0 0 0 78 0 0 0 0 0 0 33 3 
3 909 910 0 0 0 0 0 0 0 0 0 0 0 0 0 77 0 0 0 0 0 0 33 3 
3 3 3 3 3 3 3 3 3 3 3 3 3 3 3 3 3 3 3 3 3 3 3 3 3 
