1 1 1 1 1 1 1 1 1 1 1 1 1 1 1 1 1 1 1 1 1 1 1 1 1 
1 22 0 0 0 0 0 0 21 22 0 0 0 21 22 0 0 0 0 0 0 0 0 21 1 
1 0 0 0 0 0 0 0 0 0 0 0 0 0 0 0 0 0 0 0 0 0 0 0 1 
1 0 0 0 0 0 0 0 0 0 0 1301 0 0 0 0 0 0 0 0 0 0 0 0 1 
1 0 0 0 0 0 0 2 2 2 2 2 2 2 2 2 0 0 0 0 0 0 0 0 1 
1 17 0 0 0 0 0 0 0 0 0 0 0 0 0 0 0 0 0 0 0 0 0 0 1 
1 2 2 2 0 0 17 1403 0 18 0 0 4 0 0 2 2 2 2 0 0 0 0 2 1 
1 2 1101 0 0 0 2 2 2 2 0 0 5 0 0 0 0 0 0 0 0 2 2 2 1 
1 1101 0 0 0 0 0 0 0 0 0 0 0 0 0 0 0 0 0 0 0 0 0 0 1 
1 0 0 4 5 0 0 0 0 0 0 0 0 0 0 0 0 1 1 1 0 0 0 0 1 
1 0 0 0 0 0 5 5 5 0 0 0 0 0 1 1 0 0 0 0 0 0 0 0 1 
1 0 0 0 0 0 0 0 0 0 0 0 1 0 0 0 0 0 0 0 0 0 0 0 1 
1 0 0 0 0 0 0 0 0 0 0 4 5 4 0 0 0 0 0 0 0 0 0 0 1 
1 301 1 1 0 101 5 4 1 1 1 4 1 1 4 1 5 1 1 101 0 1 1 301 1 
1 301 0 0 0 0 21 1 4 5 1 1 4 1 1 1 1 1 22 0 0 0 0 301 1 
1 301 0 0 0 0 0 21 1 1 1 1 1 1 1 4 1 22 0 0 0 0 0 301 1 
1 301 0 0 0 0 0 0 0 0 0 0 0 0 0 0 0 0 0 0 0 0 0 301 1 
1 301 0 0 0 0 0 0 0 0 0 0 0 0 0 0 0 0 0 0 0 0 0 301 1 
1 301 0 1402 0 0 0 0 0 0 0 0 0 0 0 0 0 0 0 0 0 1401 0 301 1 
1 2 2 2 0 0 0 0 0 0 0 0 0 0 0 0 0 0 0 0 0 2 2 2 1 
1 2 20 0 2 2 0 0 0 0 0 0 0 0 1403 0 0 0 0 2 2 1101 19 2 1 
1 20 0 0 0 0 0 2 2 0 1 4 301 5 1 0 2 2 0 0 0 0 0 19 1 
1 0 0 0 0 0 0 0 0 0 0 0 301 0 0 0 0 0 0 0 0 0 0 0 1 
1 0 0 0 0 0 0 0 0 0 0 0 301 0 0 0 0 0 0 0 0 0 0 0 1 
1 0 0 0 0 0 0 0 0 0 0 0 301 0 0 0 0 0 0 0 0 0 0 0 1 
1 1702 0 0 0 0 0 0 0 0 0 0 301 0 0 0 0 0 0 0 0 0 0 1701 1 
1 1 22 0 0 101 101 0 0 21 1 4 1 1 5 22 0 0 101 101 301 0 21 1 1 
1 22 0 0 0 0 0 0 0 0 21 1 1 4 22 0 0 0 0 0 301 0 0 21 1 
1 0 0 0 0 0 0 0 0 0 0 21 1 22 0 0 0 0 0 0 301 0 0 0 1 
1 0 0 0 0 0 0 0 0 0 0 0 101 0 0 0 0 0 0 0 301 0 0 0 1 
1 0 0 0 0 0 0 0 0 0 0 0 0 0 0 0 0 0 0 0 301 0 0 0 1 
1 1201 1202 0 0 0 0 0 0 0 0 0 0 0 0 0 0 0 0 0 301 0 1403 0 1 
1 2 2 2 2 2 2 2 2 2 2 2 2 2 2 2 2 2 2 2 2 2 2 2 1 
1 1 1 1 1 1 1 1 1 1 1 1 1 1 1 1 1 1 1 1 1 1 1 1 1 
