0 0 0 0 0 0 0 0 0 0 0 0 0 0 0 0 0 0 0 0 0 0 0 0 0 
0 1404 1404 1404 1404 1404 1404 1404 1404 1401 1401 1401 1401 1401 1401 1401 1401 1401 1401 1401 1401 1401 1401 1401 0 
0 1404 1404 1404 1404 1404 1404 1404 1401 1401 1401 1401 1401 1401 1401 1401 1401 1401 1401 1401 1401 1401 1401 1401 0 
0 1404 1404 1404 1404 1404 1404 1404 1401 1401 1401 1401 1401 1401 1401 1401 1401 1401 1401 1401 1401 1401 1401 1401 0 
0 1404 1404 1404 1404 1404 1404 1404 1401 1401 1401 1401 1401 1401 1401 1401 1401 1401 1401 1401 1401 1401 1401 1401 0 
0 0 0 0 0 0 0 0 0 0 1401 1401 1401 1401 1401 1401 1401 1401 1401 1401 1401 1401 1401 1401 0 
0 0 0 0 0 0 0 0 0 0 1401 1401 1401 1401 1401 1401 1401 1401 1401 1401 1401 1401 1401 1401 0 
0 0 0 0 0 0 0 0 0 0 1401 1401 1401 1401 1401 1401 1401 1401 1401 1401 1401 1401 1401 1401 0 
0 1401 1401 1401 1401 1401 1401 1401 1401 1401 1401 1401 1401 1401 1401 1401 1401 1401 1401 1401 1401 1401 1401 1401 0 
0 1401 1401 1401 1401 1401 1401 1401 1401 1401 1401 1401 1401 1401 1401 1401 1401 1401 1401 1401 1401 1401 1401 1401 0 
0 1401 1401 1401 1401 1401 1401 1401 1401 1401 1401 1401 1401 1401 1401 1401 1401 1401 1401 1401 1401 1401 1401 1401 0 
0 1401 1401 0 0 0 0 0 0 0 0 0 0 0 0 0 0 0 0 0 0 0 0 0 0 
0 1401 1401 1401 1401 1401 1401 1401 1401 1401 1401 1401 1401 1401 1401 1401 1401 1401 1401 1401 1401 1401 1401 1401 0 
0 1401 1401 1401 1401 1401 1401 1401 1401 1401 1401 1401 1401 1401 1401 1401 1401 1401 1401 1401 1401 1401 1401 1401 0 
0 1401 1401 1401 1401 1401 1401 1401 1401 1401 1401 1401 1401 1401 1401 1401 1401 1401 1401 1401 1401 1401 1401 1401 0 
0 0 0 0 0 0 0 0 0 0 0 0 0 0 0 0 0 0 1401 1401 1401 1401 1401 1401 0 
0 0 0 0 0 0 0 0 1401 1401 1401 1401 1401 1401 1401 1401 1401 1401 1401 1401 1401 1401 1401 1401 0 
0 0 0 0 0 0 0 0 1401 1401 1401 1401 1401 1401 1401 1401 1401 1401 1401 1401 1401 1401 1401 1401 0 
0 0 0 0 0 0 0 0 1401 1401 1401 1401 1401 1401 1401 1401 1401 1401 1401 1401 1401 1401 1401 1401 0 
0 0 0 0 0 0 0 0 1401 0 0 0 0 0 0 0 0 0 0 0 0 0 0 0 0 
0 0 0 0 0 0 0 0 1401 0 1401 1401 1401 1401 1401 1401 1401 1401 1401 1401 1401 1401 1401 1401 0 
0 0 0 0 0 0 1401 1401 1401 0 1401 1401 1401 1401 1401 1401 1401 1401 1401 1401 1401 1401 1401 1401 0 
0 0 0 0 0 0 1401 1401 1401 0 1401 1401 1401 1401 1401 1401 1401 1401 1401 1401 1401 1401 1401 1401 0 
0 0 0 0 0 0 0 0 0 0 0 0 0 0 0 0 0 0 0 0 0 0 0 0 0 
