0 0 0 0 0 0 0 0 0 0 0 408 0 0 403 0 403 0 408 412 403 426 0 0 426 408 0 412 0 0 0 0 0 0 0 0 0 0 0 0 
435 407 407 407 407 407 407 407 407 0 506 433 0 0 436 506 437 0 408 412 403 1004 0 0 1002 408 0 1006 0 0 0 0 0 0 0 0 0 0 0 0 
408 0 0 0 0 0 0 0 0 0 502 0 0 0 0 502 0 0 408 906 403 0 0 0 0 408 0 0 0 0 0 0 0 0 0 0 0 0 0 0 
433 0 0 0 0 0 0 0 0 0 0 0 0 0 0 0 0 0 408 440 452 438 0 0 435 433 0 0 0 0 0 0 0 0 0 0 0 0 0 0 
0 0 0 0 0 0 0 0 0 0 0 0 0 0 0 0 0 0 503 0 0 403 0 0 408 0 0 0 0 0 0 0 0 0 0 0 0 0 0 0 
0 0 0 0 0 1401 0 0 0 0 0 0 0 0 0 0 0 0 502 0 0 403 0 0 408 0 0 0 0 0 0 0 0 0 0 0 0 0 0 0 
0 0 0 0 0 0 0 0 0 0 0 0 0 0 0 0 0 0 408 0 0 403 0 0 408 0 0 0 0 0 0 0 0 0 0 0 0 0 0 0 
0 0 0 0 0 0 0 0 0 0 0 1101 0 0 0 0 0 0 408 0 0 403 0 0 408 0 0 0 0 0 0 0 0 0 0 0 0 0 0 0 
0 0 0 0 707 0 1407 0 0 0 0 0 1402 0 0 0 1401 0 408 1404 0 902 0 0 904 0 1403 0 0 0 0 0 0 0 0 0 0 0 0 0 
0 0 0 0 0 0 0 0 0 0 0 0 0 0 0 0 0 0 408 0 0 403 0 0 408 0 0 0 0 0 0 0 0 0 0 0 0 0 0 0 
0 0 0 0 0 0 0 0 0 0 0 0 0 0 0 0 0 0 408 0 0 403 0 0 408 0 0 0 0 0 0 0 0 0 0 0 0 0 0 0 
0 0 0 0 0 0 0 0 0 0 0 0 0 0 0 0 0 0 408 0 0 403 0 0 408 0 0 0 0 0 0 0 0 0 0 0 0 0 0 0 
0 0 0 0 0 0 0 0 0 0 0 0 0 701 0 708 0 0 408 0 1404 403 0 0 408 1403 0 0 0 0 0 0 0 0 0 0 0 0 0 0 
0 0 0 0 0 0 0 0 0 0 0 0 0 0 0 0 0 0 408 0 0 403 0 0 408 0 0 0 0 0 0 0 0 0 0 0 0 0 0 0 
