1 1 1 1 1 1 1 1 1 1 1 1 1 1 1 1 1 1 1 1 1 1 1 1 1 
1 18 18 18 18 18 18 18 18 18 18 18 18 18 18 18 18 18 18 18 18 18 18 18 1 
1 0 0 0 0 0 0 0 0 0 0 0 0 0 0 0 0 0 0 0 0 0 0 0 1 
1 909 910 0 0 0 0 0 0 0 0 0 0 0 0 0 0 0 0 0 0 0 0 0 1 
1 1 1 1 1 1 1 1 1 1 7 709 0 708 708 708 0 708 0 0 0 0 0 0 1 
1 1 1 1 1 1 1 1 1 1 7 707 0 708 708 708 708 708 708 708 708 708 708 708 1 
1 707 707 707 0 0 0 0 0 0 7 707 0 708 708 708 708 708 708 708 708 708 708 708 1 
1 707 707 707 707 707 0 0 0 0 7 707 0 708 708 708 708 708 708 708 708 708 708 708 1 
1 707 707 707 707 0 0 0 0 0 7 707 0 708 708 708 708 708 708 708 708 708 708 708 1 
1 707 707 6 53 53 53 53 53 6 7 707 0 7 6 53 53 53 53 53 6 7 708 708 1 
1 707 707 6 53 53 53 53 53 6 707 707 0 7 6 53 53 53 53 53 6 7 0 0 1 
1 707 707 6 53 53 53 53 53 6 707 707 0 7 6 53 53 53 53 53 6 7 0 0 1 
1 707 707 6 53 53 53 53 53 6 0 707 0 7 6 53 53 53 53 53 6 7 0 0 1 
1 0 707 6 6 6 6 6 6 6 0 0 0 7 6 6 6 6 6 6 6 7 0 0 1 
1 0 0 0 0 0 0 0 0 0 0 0 0 7 51 51 708 708 708 33 708 7 708 708 1 
1 0 0 0 0 0 0 0 0 0 0 0 0 7 51 51 708 708 708 33 708 7 708 708 1 
1 0 707 707 707 707 707 707 707 707 707 707 0 7 51 51 708 708 708 33 708 7 708 708 1 
1 0 707 707 707 707 707 707 707 707 707 707 0 7 51 51 708 708 708 33 708 7 708 708 1 
1 0 707 707 707 707 707 707 707 707 707 707 0 7 51 51 708 708 708 33 708 7 708 708 1 
1 0 707 707 707 707 707 707 707 707 707 707 0 7 51 51 708 708 708 33 708 7 708 708 1 
1 0 0 0 0 0 0 0 0 0 0 0 0 7 51 51 708 708 708 33 708 7 708 708 1 
1 0 808 0 0 0 0 0 5 5 5 5 5 5 5 51 0 0 0 33 0 7 0 0 1 
1 0 5 0 0 0 0 5 5 5 5 5 5 5 5 5 0 0 0 33 0 7 0 0 1 
1 1 1 1 1 1 1 1 1 1 1 1 1 1 1 1 1 1 1 1 1 1 1 1 1 
