1 1 1 1 1 1 1 1 1 1 1 1 1 1 1 1 1 1 1 1 1 1 1 1 1 1 1 1 1 1 1 1 1 1 1 
1 22 0 0 0 0 21 22 0 0 21 22 0 0 21 22 0 0 21 22 0 0 21 22 0 0 21 22 0 0 0 0 0 21 1 
1 0 0 0 0 0 0 0 0 0 0 0 0 0 0 0 0 0 0 0 0 0 0 0 0 0 0 0 0 0 0 0 0 0 1 
1 0 0 0 0 0 0 0 0 505 0 0 0 0 0 0 0 0 0 0 0 0 0 0 0 0 0 0 0 0 0 0 0 1703 1 
1 1702 0 1301 0 1701 0 0 0 502 0 0 0 0 0 0 0 0 0 0 0 0 0 0 0 0 0 2 2 2 2 2 2 2 1 
1 2 2 2 2 2 2 1402 0 502 1401 0 0 0 0 0 0 0 0 0 0 0 0 1 1 1 1 1101 0 0 0 0 0 0 1 
1 0 0 0 0 0 0 1 5 4 4 0 0 0 0 0 0 0 0 301 1 1 1 1101 0 0 0 0 0 0 0 0 0 0 1 
1 0 0 0 0 0 0 301 506 0 0 4 1 5 1 0 0 0 0 301 0 0 0 0 0 0 0 0 0 0 0 0 0 0 1 
1 0 0 0 0 0 0 301 501 0 0 0 0 0 0 1 1 1 0 301 0 0 0 0 0 0 0 0 0 0 0 0 0 0 1 
1 0 0 0 0 0 0 301 501 0 0 0 0 0 0 0 0 0 0 301 0 0 0 0 0 0 0 0 0 1404 0 0 1403 0 1 
1 0 0 0 0 0 0 301 501 0 0 0 0 0 0 0 0 0 0 301 0 0 0 0 0 0 0 0 0 6 6 6 6 6 1 
1 0 0 0 0 0 0 301 501 0 0 0 0 0 0 0 0 0 0 301 0 0 0 0 0 1401 0 0 0 0 0 0 0 0 1 
1 1201 1202 0 0 0 0 1 501 0 0 1 1402 0 0 1 0 0 0 1 601 601 601 6 6 6 6 6 6 601 601 601 601 601 1 
1 1 1 1 1 1 1 1 1 1 1 1 1 1 1 1 1 1 1 1 1 1 1 1 1 1 1 1 1 1 1 1 1 1 1 
