0 0 0 0 0 0 0 59 0 0 0 0 0 0 0 0 0 0 0 0 0 59 0 0 0 
58 58 58 58 124 58 58 61 0 0 0 0 0 0 0 0 0 0 0 0 0 59 0 0 0 
0 0 0 0 0 0 0 0 0 0 0 0 0 0 0 0 0 0 0 0 0 115 0 0 0 
0 0 0 0 0 0 63 58 58 58 58 58 58 62 0 0 0 0 0 0 0 59 0 0 0 
0 0 0 0 0 0 59 0 0 0 0 0 0 0 0 0 0 0 0 0 0 59 0 0 0 
0 0 0 0 0 63 61 0 0 0 0 0 0 0 0 0 0 0 0 0 0 59 0 0 0 
0 0 0 0 0 59 0 0 0 0 0 0 0 0 0 0 100 0 0 0 0 59 0 0 0 
0 0 0 0 0 59 0 0 0 0 0 0 0 0 0 0 0 0 0 0 0 0 0 0 0 
58 58 58 58 58 103 0 0 0 0 0 0 0 0 0 0 0 0 0 0 0 0 0 0 0 
0 0 0 0 0 0 0 0 0 0 0 0 0 0 0 0 0 0 0 0 0 0 0 0 0 
63 58 58 58 58 58 58 58 58 58 58 58 58 58 58 58 118 58 58 62 0 0 0 0 0 
59 0 0 0 0 0 0 0 0 0 0 0 0 0 0 0 0 0 0 59 0 0 0 0 0 
59 0 0 0 0 0 0 94 0 0 0 0 0 0 0 0 0 0 0 59 0 0 0 0 0 
59 0 0 0 0 0 0 0 0 0 0 0 0 0 0 0 0 0 0 59 0 0 0 0 0 
