0 0 0 0 0 0 0 0 0 0 0 0 0 0 0 0 0 0 0 0 0 0 0 0 0 
0 1404 1404 1404 1404 1404 1404 1404 1404 1401 0 1401 1401 1401 1401 1401 1401 1401 1401 1401 1401 1401 1401 1401 0 
0 1404 1404 1404 1404 1404 1404 1404 1401 1401 0 1401 1401 1401 1401 1401 1401 1401 1401 1401 1401 1401 1401 1401 0 
0 1404 1404 1404 1404 1404 1404 1404 1401 1401 0 1401 1401 1401 1401 1401 1401 1401 1401 1401 1401 1401 1401 1401 0 
0 1404 1404 1404 1404 1404 1404 1404 1401 1401 1801 1401 1401 1401 1401 1401 1401 1401 1401 1401 1401 1401 1401 1401 0 
0 103 103 103 103 103 103 103 103 103 1401 1401 1401 1401 1401 1401 1401 1401 1401 1401 1401 1401 1401 1401 0 
0 11 205 0 12 204 14 11 13 205 1401 1401 1401 1401 1401 1401 1401 1401 1401 1401 1401 1401 1401 1401 0 
0 0 0 0 0 0 0 0 0 0 1401 1401 1401 1401 1401 1401 1401 1401 1401 1401 1401 1401 1401 1401 0 
0 0 0 1401 1401 1401 1401 1401 1401 1401 1401 1401 1401 1401 1401 1401 1401 1401 1401 1401 1401 1401 1401 1401 0 
0 0 0 1401 1401 1401 1401 1401 1401 1401 1401 1401 1401 1401 1401 1401 1401 1401 1401 1401 1401 1401 1401 1401 0 
0 0 1801 1401 1401 1401 1401 1401 1401 1401 1401 1401 1401 1401 1401 1401 1401 1401 1401 1401 1401 1401 1401 1401 0 
0 1401 1401 103 103 103 103 103 103 103 103 103 103 103 103 103 103 103 103 103 103 103 103 103 0 
0 1401 1401 1401 1401 1401 1401 1401 1401 1401 1401 1401 1401 1401 1401 1401 1401 1401 1401 1401 1401 1401 1401 1401 0 
0 1401 1401 1401 1401 1401 1401 1401 1401 1401 1401 1401 1401 1401 1401 1401 1401 1401 0 1401 1401 1401 1401 1401 0 
0 1401 1401 1401 1401 1401 1401 1401 1401 1401 1401 1401 1401 1401 1401 1401 1401 1401 1801 0 1401 1401 1401 1401 0 
0 105 105 105 105 105 105 105 105 105 105 105 105 105 105 105 105 105 1401 1401 1401 1401 1401 1401 0 
0 0 0 0 0 0 0 0 0 0 1401 1401 1401 1401 1401 1401 1401 1401 1401 1401 1401 1401 1401 1401 0 
0 0 0 0 0 0 0 0 0 1401 1401 1401 1401 1401 1401 1401 1401 1401 1401 1401 1401 1401 1401 1401 0 
0 0 0 0 0 0 0 0 0 1801 1401 1401 1401 1401 1401 1401 1401 1401 1401 1401 1401 1401 1401 1401 0 
0 0 0 0 0 0 0 0 1401 0 0 102 102 102 102 102 102 102 102 102 102 102 102 102 0 
0 0 0 0 0 0 0 0 1401 0 1401 1401 1401 1401 1401 1401 1401 1401 1401 1401 1401 1401 1401 1401 0 
0 0 0 0 0 0 1401 1401 1401 0 1401 1401 1401 1401 1401 1401 1401 1401 1401 1401 1401 1401 1401 1401 0 
0 0 0 0 0 0 1401 1401 1401 0 1401 1401 1401 1401 1401 1401 1401 1401 1401 1401 1401 1401 1401 1401 0 
0 0 0 0 0 0 0 0 0 0 0 0 0 0 0 0 0 0 0 0 0 0 0 0 0 
