1 1 1 1 1 1 1 1 1 1 1 1 1 1 1 1 1 1 1 1 1 1 1 1 1 
1 0 0 0 0 0 0 0 0 0 0 0 0 0 0 0 0 0 0 0 0 0 0 0 1 
1 0 0 0 0 0 0 0 0 0 0 0 0 0 0 0 0 0 0 0 0 0 0 0 1 
1 0 0 0 0 0 0 0 0 0 0 0 0 0 0 0 0 0 0 0 0 0 0 0 1 
1 1 1 1 1 1 1 1 1 22 0 0 0 0 0 21 1 1 1 1 1 1 1 1 1 
1 601 601 601 601 601 601 601 601 0 0 0 0 0 0 601 601 601 601 601 601 601 601 601 1 
1 601 601 601 601 601 601 601 601 0 0 0 0 0 0 601 601 601 601 601 601 601 601 601 1 
1 601 601 601 601 601 601 601 601 0 0 0 0 0 0 601 601 601 601 601 601 601 601 601 1 
1 601 601 601 601 601 601 601 0 0 0 0 0 0 0 601 601 601 601 601 601 601 601 601 1 
1 601 601 601 601 601 601 601 0 0 0 0 0 0 0 601 601 601 601 601 601 601 601 601 1 
1 601 601 601 601 601 601 0 0 0 0 0 0 0 601 601 601 601 601 601 601 601 601 601 1 
1 601 601 601 601 601 0 0 0 0 0 0 0 601 601 601 601 601 601 601 601 601 601 601 1 
1 601 601 601 601 0 0 0 0 0 0 0 601 601 601 601 601 601 601 601 601 601 601 601 1 
1 601 601 601 601 0 0 0 0 0 0 0 601 601 601 601 601 601 601 601 601 601 601 601 1 
1 601 601 601 601 0 0 0 0 0 0 601 601 601 601 601 601 601 601 601 601 601 601 601 1 
1 601 601 601 601 0 0 0 0 0 601 601 601 601 601 601 601 601 601 601 601 601 601 601 1 
1 601 601 601 601 0 0 0 0 0 601 601 601 601 601 601 601 601 601 601 601 601 601 601 1 
1 601 601 601 601 0 0 0 0 0 601 601 601 601 601 601 601 601 601 601 601 601 601 601 1 
1 601 601 601 601 0 0 0 0 0 601 601 601 601 601 601 601 601 601 601 601 601 601 601 1 
1 601 601 601 601 0 0 0 0 0 0 601 601 601 601 601 601 601 601 601 601 601 601 601 1 
1 601 601 601 601 601 0 0 0 0 0 0 601 601 601 601 601 601 601 601 601 601 601 601 1 
1 601 601 601 601 601 0 0 0 0 0 0 0 601 601 601 601 601 601 601 601 601 601 601 1 
1 601 601 601 601 601 601 0 0 0 0 0 0 0 601 601 601 601 601 601 601 601 601 601 1 
1 601 601 601 601 601 601 601 0 0 0 0 0 0 0 601 601 601 601 601 601 601 601 601 1 
1 601 601 601 601 601 601 601 601 0 0 0 0 0 0 0 601 601 601 601 601 601 601 601 1 
1 601 601 601 601 601 601 601 601 601 0 0 0 0 0 0 601 601 601 601 601 601 601 601 1 
1 601 601 601 601 601 601 601 601 601 601 0 0 0 0 0 0 601 601 601 601 601 601 601 1 
1 601 601 601 601 601 601 601 601 601 601 601 0 0 0 0 0 0 601 601 601 601 601 601 1 
1 601 601 601 601 601 601 601 601 601 601 601 601 0 0 0 0 0 0 601 601 601 601 601 1 
1 601 601 601 601 601 601 601 601 601 601 601 601 601 0 0 0 0 0 601 601 601 601 601 1 
1 601 601 601 601 601 601 601 601 601 601 601 601 601 0 0 0 0 0 601 601 601 601 601 1 
1 601 601 601 601 601 601 601 601 601 601 601 601 601 0 0 0 0 0 601 601 601 601 601 1 
1 601 601 601 601 601 601 601 601 601 601 601 601 0 0 0 0 0 0 601 601 601 601 601 1 
1 601 601 601 601 601 601 601 601 601 601 601 601 0 0 0 0 0 0 601 601 601 601 601 1 
1 601 601 601 601 601 601 601 601 601 601 601 0 0 0 0 0 0 0 601 601 601 601 601 1 
1 601 601 601 601 601 601 601 601 601 601 0 0 0 0 0 0 0 601 601 601 601 601 601 1 
1 601 601 601 601 601 601 601 601 601 0 0 0 0 0 0 601 601 601 601 601 601 601 601 1 
1 601 601 601 601 601 601 601 601 0 0 0 0 0 0 601 601 601 601 601 601 601 601 601 1 
1 601 601 601 601 601 601 601 0 0 0 0 0 0 601 601 601 601 601 601 601 601 601 601 1 
1 601 601 601 601 601 601 0 0 0 0 0 0 601 601 601 601 601 601 601 601 601 601 601 1 
1 601 601 601 601 601 0 0 0 0 0 0 601 601 601 601 601 601 601 601 601 601 601 601 1 
0 601 601 601 601 0 0 0 0 0 0 601 601 601 601 601 601 601 601 601 601 601 601 601 1 
0 601 601 601 0 0 0 0 0 0 601 601 601 601 601 601 601 601 601 601 601 601 601 601 1 
0 601 601 0 0 0 0 0 0 601 601 601 601 601 601 601 601 601 601 601 601 601 601 601 1 
0 601 601 0 0 0 0 0 601 601 601 601 601 601 601 601 601 601 601 601 601 601 601 601 1 
1 601 601 0 0 0 0 0 601 601 601 601 601 601 601 601 601 601 601 601 601 601 601 601 1 
1 601 601 0 0 0 0 0 601 601 601 601 601 601 601 601 601 601 601 601 601 601 601 601 1 
1 601 601 0 0 0 0 0 601 601 601 601 601 601 601 601 601 601 601 601 601 601 601 601 1 
1 601 601 0 0 0 0 0 0 601 601 601 601 601 601 601 601 601 601 601 601 601 601 601 1 
1 601 601 0 0 0 0 0 0 601 601 601 601 601 601 601 601 601 601 601 601 601 601 601 1 
1 601 601 601 0 0 0 0 0 0 601 601 601 601 601 601 601 601 601 601 601 601 601 601 1 
1 601 601 601 601 0 0 0 0 0 0 601 601 601 601 601 601 601 601 601 601 601 601 601 1 
1 601 601 601 601 0 0 0 0 0 0 601 601 601 601 601 601 601 601 601 601 601 601 601 1 
1 601 601 601 601 601 0 0 0 0 0 601 601 601 601 601 601 601 601 601 601 601 601 601 1 
1 601 601 601 601 601 0 0 0 0 0 0 601 601 601 601 601 601 601 601 601 601 601 601 1 
1 601 601 601 601 601 601 0 0 0 0 0 601 601 601 601 601 601 601 601 601 601 601 601 1 
1 601 601 601 601 601 601 0 0 0 0 0 0 601 601 601 601 601 601 601 601 601 601 601 1 
1 601 601 601 601 601 601 601 0 0 0 0 0 601 601 601 601 601 601 601 601 601 601 601 1 
1 601 601 601 601 601 601 601 0 0 0 0 0 0 601 601 601 601 601 601 601 601 601 601 1 
1 601 601 601 601 601 601 601 601 0 0 0 0 0 0 601 601 601 601 601 601 601 601 601 1 
1 601 601 601 601 601 601 601 601 0 0 0 0 0 0 601 601 601 601 601 601 601 601 601 1 
1 601 601 601 601 601 601 601 601 601 0 0 0 0 0 0 601 601 601 601 601 601 601 601 1 
1 601 601 601 601 601 601 601 601 601 0 0 0 0 0 0 601 601 601 601 601 601 601 601 1 
1 601 601 601 601 601 601 601 601 601 601 0 0 0 0 0 0 601 601 601 601 601 601 601 1 
1 601 601 601 601 601 601 601 601 601 601 0 0 0 0 0 0 0 601 601 601 601 601 601 1 
1 601 601 601 601 601 601 601 601 601 601 601 0 0 0 0 0 0 0 601 601 601 601 601 1 
1 601 601 601 601 601 601 601 601 601 601 601 601 0 0 0 0 0 0 601 601 601 601 601 1 
1 601 601 601 601 601 601 601 601 601 601 601 601 0 0 0 0 0 0 0 601 601 601 601 1 
1 601 601 601 601 601 601 601 601 601 601 601 601 601 0 0 0 0 0 0 601 601 601 601 1 
1 601 601 601 601 601 601 601 601 601 601 601 601 601 601 0 0 0 0 0 601 601 601 601 1 
1 601 601 601 601 601 601 601 601 601 601 601 601 601 601 0 0 0 0 0 601 601 601 601 1 
1 601 601 601 601 601 601 601 601 601 601 601 601 601 0 0 0 0 0 601 601 601 601 601 1 
1 601 601 601 601 601 601 601 601 601 601 601 601 0 0 0 0 0 0 601 601 601 601 601 1 
1 601 601 601 601 601 601 601 601 601 601 601 0 0 0 0 0 0 601 601 601 601 601 601 1 
1 601 601 601 601 601 601 601 601 601 601 0 0 0 0 0 0 0 601 601 601 601 601 601 1 
1 601 601 601 601 601 601 601 601 601 0 0 0 0 0 0 0 601 601 601 601 601 601 601 1 
1 601 601 601 601 601 601 601 601 0 0 0 0 0 0 0 601 601 601 601 601 601 601 601 1 
1 601 601 601 601 601 601 601 0 0 0 0 0 0 0 601 601 601 601 601 601 601 601 601 1 
1 601 601 601 601 601 601 0 0 0 0 0 0 0 601 601 601 601 601 601 601 601 601 601 1 
1 601 601 601 601 601 0 0 0 0 0 0 0 601 601 601 601 601 601 601 601 601 601 601 1 
1 601 601 601 601 601 0 0 0 0 0 0 601 601 601 601 601 601 601 601 601 601 601 601 1 
1 601 601 601 601 601 0 0 0 0 0 601 601 601 601 601 601 601 601 601 601 601 601 601 1 
1 601 601 601 601 601 0 0 0 0 0 601 601 601 601 601 601 601 601 601 601 601 601 601 1 
1 601 601 601 601 601 601 0 0 0 0 0 601 601 601 601 601 601 601 601 601 601 601 601 1 
1 601 601 601 601 601 601 0 0 0 0 0 601 601 601 601 601 601 601 601 601 601 601 601 1 
1 601 601 601 601 601 601 601 0 0 0 0 601 601 601 601 601 601 601 601 601 601 601 601 1 
1 601 601 601 601 601 601 601 0 0 0 0 0 601 601 601 601 601 601 601 601 601 601 601 1 
1 601 601 601 601 601 601 601 601 0 0 0 0 0 601 601 601 601 601 601 601 601 601 601 1 
1 601 601 601 601 601 601 601 601 0 0 0 0 0 0 0 601 601 601 601 601 601 601 601 1 
1 601 601 601 601 601 601 601 601 601 0 0 0 0 0 0 0 601 0 0 0 601 601 601 1 
1 601 601 601 601 601 601 601 601 601 601 0 0 0 0 0 0 0 0 601 0 0 601 601 1 
1 601 601 601 601 601 601 601 601 601 601 601 0 0 0 0 0 0 0 601 601 0 0 601 1 
1 601 601 601 601 601 601 601 601 601 601 601 601 0 0 0 0 0 0 0 0 601 0 0 1 
1 601 601 601 601 601 601 601 601 601 601 601 601 0 0 0 0 0 0 0 0 0 0 601 1 
1 601 601 601 601 601 601 601 601 601 601 601 601 601 601 0 0 0 0 0 0 0 601 601 1 
1 601 601 601 601 601 601 601 601 601 601 601 601 601 601 601 0 0 0 0 0 601 601 601 1 
1 601 601 601 601 601 601 601 601 601 601 601 601 601 601 601 0 0 0 0 0 601 601 601 1 
1 601 601 601 601 601 601 601 601 601 601 601 601 601 601 601 0 0 0 0 0 601 601 601 1 
1 601 601 601 601 601 601 601 601 601 601 601 601 601 601 601 0 0 0 0 0 0 601 601 1 
1 601 601 601 601 601 601 601 601 601 601 601 601 601 601 601 0 0 0 0 0 0 601 601 1 
1 601 601 601 601 601 601 601 601 601 601 601 601 601 601 0 0 0 0 0 0 601 601 601 1 
1 601 601 601 601 601 601 601 601 601 601 601 601 601 0 0 0 0 0 0 601 601 601 601 1 
1 601 601 601 601 601 601 601 601 601 601 601 601 0 0 0 0 0 0 601 601 601 601 601 1 
1 601 601 601 601 601 601 601 601 601 601 601 601 0 0 0 0 0 601 601 601 601 601 601 1 
1 601 601 601 601 601 601 601 601 601 601 601 0 0 0 0 0 601 601 601 601 601 601 601 1 
1 601 601 601 601 601 601 601 601 601 601 0 0 0 0 0 601 601 601 601 601 601 601 601 1 
1 601 601 601 601 601 601 601 601 601 0 0 0 0 0 601 601 601 601 601 601 601 601 601 1 
1 0 0 0 0 0 0 0 0 0 0 0 0 0 0 0 0 0 0 0 0 0 0 0 1 
1 0 0 0 0 0 0 0 0 0 0 0 0 0 0 0 0 0 0 0 0 0 0 0 1 
1 0 0 0 0 0 0 0 0 0 0 0 0 0 0 0 0 0 0 0 0 0 0 0 1 
1 0 0 0 0 0 0 0 0 0 1 1 1 1 1 0 0 0 0 0 0 0 0 0 1 
1 0 0 0 0 0 0 0 0 0 0 0 0 0 0 0 0 0 0 0 0 0 0 0 1 
1 0 0 0 0 0 0 0 0 0 0 0 0 0 0 0 0 0 0 0 0 0 0 0 1 
1 1 1 1 1 1 1 1 1 1 1 1 1 1 1 1 1 1 1 1 1 1 1 1 1 
